##########
####====##
####=##=##
####=##===
=====#####
##########
##########
##########
##########
##########