##########
##########
##########
=====#####
####=#####
####=#####
####=#####
####======
##########
##########