##########
##########
##===#####
##=#=#####
===#=###==
####=###=#
####=###=#
####=###=#
####=====#
##########