##########
##===#####
##=#=#####
##=#====##
##=####=##
##=####=##
##=#====##
##=#=#####
===#======
##########