##########
==##===#==
#=##=#=#=#
#====#=#=#
######=#=#
#======#=#
#=######=#
#=######=#
#========#
##########