##########
==##====##
#==#=##=##
##=#=#==##
##=#=#=###
#==#=#=###
#=##=#=#==
#=##=#=#=#
#====#===#
##########